##### ##########      #### ### #   ##
S          #     #### ##       # ## #
#  ######  # ####      #  ### #     #
# #      #      # ####   #  #  #### #
# # #  # #  ##### ###### ## #       #
#  #  #  # #      ######     ###  # #
#     ## ### ##############     #####
########     ##############F###     #