##############################
#            #               F
############ ############### #
S     #                #     #
# # ########## ######### #####
# #                      #####
##############################